[level]
tileset = ground.png
map = ..................
      .#####.##.........
      .#...#..#.........
      .#...####.........
      .##.##............
      ..................
      ..................
      ..................
      ..................
      ......bbb.........
      ..................
      ..................
      ..................
      ..................
      ..................
      ..................
      ..................
      ..................
      ..................
      ..................

[.]
name = floor
tile = 0, 3

[#]
name = wall
wall = true
block = true

[b]
name = crate
tile = 0, 3
block = true
sprite = skeleton.png